      @     @      
      @     @      
      @     @      
      @     @      
      @     @      
      @     @      
      @     @      
      @     @      
      @     @      
      @     @      
      @     @      
      @     @      
      @     @      
      @     @  
      @     @      
      @     @      
      @     @      
      @     @      
      @     @      
      @     @      
      @     @      
      @     @      
      @     @      
      @     @      
      @     @      
      @     @      
      @  P  @          
      @@@@@@@      
