@@@@@@@@@@@@@@@@@@@@@@@@@@@@@@@@
@    C   #                     @
@      P #                     @
@#########   M                 @
@                   M          @
@         A                    @
@     A        M               @
@          A         M         @
@  A                           @
@       M              A       @
@              M               @
@        A                     @
@                              @
@@@@@@@@@@@@@@@@@@@@@@@@@@@@@@@@