@@@@@@@@@@@@@@@@@@@
@M   # # S  #   # @
@### # #    ###   @
@    # #    ##### @
@# #   #   W#     @
@# ### #    # ####@
@    # #E   #     @
@ #### #    ## ## @
@ #    #    #   # @
@ ######    ##### @
@   #N      #A  # @
@ #### ## P ### # @
@       #       # @
@@@@@@@@@@@@@@@@@@@