@@@@@@@@@@@@@@@@@@@
@M   #   #A#    # @
@### # # #   ##   @
@    # # # ###### @
@# #        #     @
@# ### #### # ####@
@    # #    #     @
@ #### #### ## ## @
@ #       #     # @
@ #######   ##### @
@         # #A  #P@
@ #### #### ### # @
@       #       #C@
@@@@@@@@@@@@@@@@@@@