@@@@@@@@@@@@@@@@@@@
@   #         #   @
@   #     #       @
@ ###   ### ######@
@       #         @
@  ######   ######@
@  #    #   #  #  @
@    ## #   # A#  @
@###  # ### #  #  @
@     #  #  # P#  @
@  #  #     #  #  @
@  #  #  #  # C#  @
@  #  #  #  #  #  @
@@@@@@@@@@@@@@@@@@@