@@@@@@@@@@@@@@@@@@@
@M   #E  #A#    # @
@### # # #   ##   @
@    # # # ###### @
@# #        # S   @
@# ### #### # ####@
@   W# #    #     @
@ #### #### ## ## @
@ #       #     # @
@ #######   ##### @
@         # #A  #P@
@ #### #### ### # @
@E      #N      #C@
@@@@@@@@@@@@@@@@@@@