@@@@@@@@@@@@@@@@@@@
@M   # # W  #   # @
@### # #    ###   @
@    # #    ##### @
@# #   #   W#     @
@# ### #    # ####@
@    # #W   #     @
@ #### #    ## ## @
@ #    #    #   # @
@ ######    ##### @
@   #W      #A  #P@
@ #### ## P ### # @
@       #       # @
@@@@@@@@@@@@@@@@@@@